1111111111111
1CC1C000001C1
1000011110001
1P110111E0C11
1111111111111