1111111111111111
10000000000000E1
1000001001111M01
10C00110M0000101
1000101000000101
1001001000001001
10111110CC010001
1000001000100001
1000001001111101
1P0000000C0000M1
1111111111111111