11111111111
1E000111111
1C000111111
10000000E01
100000P1111
11111111111